1111111111111
1111111110E11
111C00P0C0011
1100011110C11
1111111111111
